San_Ramon,_California	TRIGA	
			
Cornell_University	Ithaca,_New_York	TRIGA	
Dow_Chemical_Company	Midland,_Michigan	TRIGA	
General_Electric	Sunol,_California		
Idaho_State_University	Pocatello,_Idaho		
			
Massachusetts_Institute_of_Technology	Cambridge,_Massachusetts		
	Gaithersburg,_Maryland	TRIGA	
North_Carolina_State_University	Raleigh,_North_Carolina	
Ohio_State_University	Columbus,_Ohio		
Oregon_State_University	Corvallis,_Oregon	TRIGA	
Pennsylvania_State_University	University_Park,_Pennsylvania	TRIGA	
Purdue_University	West_Lafayette,_Indiana	Lockheed_(comics)	
Reed_College	Portland,_Oregon	TRIGA	
Rensselaer_Polytechnic_Institute	Schenectady,_New_York		
	
Texas_A\ampM_University	College_Station,_Texas	TRIGA	
University_of_Arizona	Tucson,_Arizona	TRIGA	
University_of_California,_Davis	Sacramento,_California		
University_of_California,_Irvine	Irvine,_California	TRIGA	
University_of_Florida	Gainesville,_Florida		
University_of_Maryland,_College_Park	College_Park,_Maryland	TRIGA	
University_of_Massachusetts_Lowell			
University_of_Michigan			
	Columbia,_Missouri		
Malaysia_University_of_Science_\amp_Technology	Rolla,_Missouri		
University_of_New_Mexico	Albuquerque,_New_Mexico	Galaxy_AGN_classification	
University_of_Texas_at_Austin	Austin,_Texas	TRIGA	
University_of_Utah	Salt_Lake_City,_Utah	TRIGA	
University_of_Wisconsin-Madison	Madison,_Wisconsin	TRIGA	
United_States_Geological_Survey	Denver,_Colorado	TRIGA	
Omaha,_Nebraska	TRIGA	
Washington_State_University	Pullman,_Washington	TRIGA	
Worcester_Polytechnic_Institute	Worcester_County,_Massachusetts		
