Jos√©_Ferrer	Cyrano_de_Bergerac_(1950_film)	
Fredric_March		
Gary_Cooper		
Spencer_Tracy	
Marlon_Brando	On_the_Waterfront	
Ernest_Borgnine	Marty	
Kirk_Douglas	Lust_for_Life_(film)	
Alec_Guinness	The_Bridge_on_the_River_Kwai	
David_Niven	Separate_Tables	
Anthony_Franciosa		
Burt_Lancaster	Elmer_Gantry_(film)	
Maximilian_Schell	Judgment_at_Nuremberg	
Gregory_Peck	To_Kill_a_Mockingbird_(film)	
Sidney_Poitier	Lilies_of_the_Field	
	Becket_(film)	
Omar_Sharif	Doctor_Zhivago_(film)	
Paul_Scofield	A_Man_for_All_Seasons_(1966_film)	
Rod_Steiger	In_the_Heat_of_the_Night_(film)	
		
John_Wayne		
George_C._Scott	Patton_(film)	
Gene_Hackman	The_French_Connection_(film)	
Marlon_Brando		
Al_Pacino		
Jack_Nicholson	Chinatown_(film)	
Jack_Nicholson		
Peter_Finch	Network_(film)	
Richard_Burton	Equus_(film)	
Jon_Voight		
Dustin_Hoffman	Kramer_vs._Kramer	
Robert_De_Niro	Raging_Bull	
Henry_Fonda		
Ben_Kingsley	Gandhi_(film)	
Tom_Courtenay	The_Dresser	
F._Murray_Abraham	Amadeus_(film)	
Jon_Voight	Runaway_Train_(film)	
Bob_Hoskins	Mona_Lisa_(film)	
Michael_Douglas	Wall_Street_(film)	
Dustin_Hoffman	Rain_Man	
Tom_Cruise	Born_on_the_Fourth_of_July_(film)	
Jeremy_Irons		
Nick_Nolte	The_Prince_of_Tides	
Al_Pacino		
Tom_Hanks	Philadelphia_(film)	
Tom_Hanks	Forrest_Gump	
Nicolas_Cage	Leaving_Las_Vegas	
Geoffrey_Rush	Shine_(film)	
Peter_Fonda		
Jim_Carrey	The_Truman_Show	
Denzel_Washington		
Tom_Hanks	Cast_Away	
		
Jack_Nicholson	About_Schmidt	
Sean_Penn	Mystic_River_(film)	
Leonardo_DiCaprio		
